XYZrobotServoError	KEYWORD1
XYZrobotServoBaudRate	KEYWORD1
XYZrobotServoBaudRateToInt	KEYWORD2
XYZrobotServoAckPolicy	KEYWORD1
XYZrobotServoSpdctrlPolicy	KEYWORD1
XYZrobotServoStatus	KEYWORD1
XYZrobotServo	KEYWORD1
eepromWrite	KEYWORD2
eepromRead	KEYWORD2
ramWrite	KEYWORD2
ramRead	KEYWORD2
writeBaudRateEeprom	KEYWORD2
readBaudRateEeprom	KEYWORD2
writeIdEeprom	KEYWORD2
readIdEeprom	KEYWORD2
writeIdRam	KEYWORD2
writeAckPolicyEeprom	KEYWORD2
readAckPolicyEeprom	KEYWORD2
writeAckPolicyRam	KEYWORD2
writeAlarmLedPolicyRam	KEYWORD2
writeSpdctrlPolicyRam	KEYWORD2
writeMaxPwmRam	KEYWORD2
writeLedControl	KEYWORD2
readAckPolicyRam	KEYWORD2
readStatus	KEYWORD2
readPwm	KEYWORD2
readPosition	KEYWORD2
readPosRef	KEYWORD2
readIBus	KEYWORD2
setPosition	KEYWORD2
setSpeed	KEYWORD2
torqueOff	KEYWORD2
rollback	KEYWORD2
reboot	KEYWORD2
getLastError	KEYWORD2
getId	KEYWORD2
